11111111111111
1000001C100001
1P000000000111
100000C00001C1
11111110000111
1E0000100C0001
11111111111111