11111111111
1000001C1M1
1000001C101
100P0010101
10000000001
1W000001001
10000001E01
1000C001001
100000M00C1
11111111111
