1111111111
1000000C11
100P000001
1000000101
1000000101
10000001E1
1111111111
