111111111111
1000001C1M01
1000001C1001
100P00101001
1W0000000101
10000000M101
100000000101
100M0001EM01
1100C0010101
10000MM00C01
111111111111
