11111111111
1000001C1M1
1000001C101
100P0010101
1M000000001
1W000001001
100M0001E01
1100C001001
10000MM00C1
11111111111
