111111111111
1M00001C10W1
1000001C0001
100P00101001
100000000101
10000000M101
100000100101
100M001MEM01
1100C0100001
1M000MM00CM1
111111111111
