11111111111
1000001C101
1000001C101
100P0010101
10000000001
10000001001
10000001E01
11111111111
