11111111111111111111111111
10000000000000000001000011
10000P0000E00C000001000011
10000000000000000001000011
10000000000000000001000001
10000000000000000001000001
11111111111111111111111111
