1111111111
1000001C11
100P001011
1000000001
1000000101
10000001E1
1111111111
