11111111
10000011
1P000001
1C0001C1
10000001
1E0C0001
11111111