11111111111111
10000000000001
1P000000000000
100000C00001C1
11111110000001
100000000C0001
11111111111111