11111111111111
1P000000000001
10000000000001
1E0000C00001C1
10000000000001
11111111111111