111111111111111
1P000CC000000E1
111111111111111