111111111111111111111111111
1WC0000000000000000P1111111
111111111111000000000011111
1000000000000002200000000E1
111111111111111111111111111
